1,0,1,0,0,0
2,0,1,0,1,0
3,0,1,0,1,0
4,0,1,0,1,0
5,0,1,0,2,0
6,0,1,0,2,0
7,0,1,0,0,0
8,0,1,0,1,0
9,0,1,0,2,0
10,0,1,0,0,0
11,0,1,0,1,0
12,0,1,0,2,0
20,1,1,0,0,10
21,0,1,0,0,0
22,0,1,0,1,0
23,0,2,0,1,0
24,0,2,0,2,0
25,0,1,0,2,0
26,0,1,1,0,0
27,0,2,1,1,0
28,0,2,1,2,0
29,0,2,1,1,0
30,0,1,1,0,0
31,1,1,0,0,10
32,0,1,0,0,0
33,0,1,0,1,0
34,0,1,0,2,0
35,0,1,0,1,0
36,0,1,0,2,0
37,0,1,0,1,0
38,0,1,0,1,0
39,0,1,0,1,0
40,0,1,0,1,0
41,0,1,0,0,0
42,0,1,0,1,0
43,0,1,0,2,0
44,0,1,1,1,0
45,0,1,1,2,0
46,0,1,1,0,0
47,0,1,1,0,0
48,0,1,1,0,0
49,0,1,1,1,0
50,0,1,1,2,0
51,0,1,1,0,0
52,0,1,0,1,0
53,0,1,0,2,0
54,0,1,0,0,0
55,0,1,0,1,0
56,0,1,0,2,0
57,0,1,0,0,0
